11111111P11111
1............1
1.1.1.....1..1
1.1.......1..1
1.1...1...1..1
1.1...1...1..1
1.1...1...1111
1............1
11X11111111111
