1111111111P111111
1...............1
1...1.1.....1...1
1...1.......1...1
1...1...1...1...1
1...1...1...1...1
1...1...1...11111
1...............1
1111X111111111111
