11111P111
1.......1
1.......1
1.......1
1.......1
1.......1
1.......1
1.......1
11X111111
