11111O111
1       1
1       1
1       1
1       1
1       1
1       1
1       1
11X111111